11111111111111
1P000000000001
100110000001C1
10000000001111
10000C000000E1
11111111111111